10 10
 1 1 1 2 2 2 3 3 4 4
 1 2 2 2 3 3 3 4 4 5
 1 2 3 3 3 4 4 4 4 5
 1 2 3 4 4 4 3 4 4 5
 1 3 4 4 4 4 4 4 4 5
 1 4 4 4 3 3 3 4 3 5
 1 3 3 3 3 2 3 4 5 6
 1 2 3 3 3 3 3 5 6 6
 1 2 2 3 3 3 3 5 6 7
 1 2 2 3 3 4 5 6 7 7
